buy - mai
arrive - dao
finish - le
home - jia
milk - niu nai
cow - niu
bubble; pearl - zhen zhu
tea - cha
coffee - ka fei
how much - duo shao qian
green - lu
red - hong
black - hei
prefer - bi jiao xi huan
xi huan - like
fast - kuai
compare - bi jiao
money - qian
everyone; everybody - da jia
end of lesson - xia ke
this - zhe ge
that - na ge
drink - he
eat - chi
fried rice - chao fan
fried noodles - chao mian
one - yi
two - er
three - san
four - si
five - wu
six - liu
seven - qi
eight - ba
nine - jiu
ten - shi